5 5 5 5 5 5 5 5 2 2 2 2 2 2 2 2 5
5 5 5 5 5 5 5 5 2 0 0 0 0 0 1 2 5
5 5 5 5 5 5 5 5 2 0 3 2 3 0 2 2 5
5 5 5 5 5 5 5 5 2 0 3 0 0 3 2 5 5
5 5 5 5 5 5 5 5 2 0 3 0 3 0 2 5 5
2 2 2 2 2 2 2 2 2 0 3 0 2 0 2 2 2
2 4 4 4 4 0 0 2 2 0 3 0 0 3 0 0 2
2 2 4 4 4 0 0 0 0 3 0 0 3 0 0 0 2
2 4 4 4 4 0 0 2 2 2 2 2 2 2 2 2 2
2 2 2 2 2 2 2 2 5 5 5 5 5 5 5 5 5